##############
#            #
#            #
#            #
#            #
#       6    #
#      ##    #
#  2     4 5 #
##1###3 ######
##############

1 blue
2 green
3 green
4 red
5 blue
6 red