##############
#            #
#            #
#            #
#            #
#            #
#     4   5  #
#   1 2   3  #
##### # # ####
##############

1 red
2 red
3 red
4 yellow
5 yellow