##############
#            #
#            #
#            #
#            #
#   45  # 6  #
### ###3###  #
#      2     #
### ###1######
##############

1 red
2 blue
3 red
4 blue
5 yellow
5 yellow