##############
#            #
#       5    #
#       4    #
#       #    #
# 1 2        #
# 1 2      3 #
### #      ###
##### ########
##############

1 blue
2 red
3 blue
4 blue
5 red
