##############
#            #
#            #
#            #
#34  55      #
### #### ##  #
#12          #
#####  ##   ##
###### ##  ###
##############

1 red
2 green
3 red
4 green
5 green
