##############
#            #
#       6    #
#       ##   #
# 4   5      #
# # ### # 3  #
#         # 2#
#       1 ####
#   ##########
##############

1 red
2 blue
3 green
4 red
5 blue
6 green
