##############
#            #
#            #
#            #
#            #
#          45#
#    #     ###
#1        33##
##  2#  # ####
##############

1 blue
2 red anchored
3 x
4 red
5 blue